box	B AA K S
chibi	CH IY B IH
cold	K OW L D
computer	K AH M P Y UW T ER
digits	D IH JH AH T S
execute	EH K S AH K Y UW T
forecast	F AO R K AE S T
hi	HH AY
is	IH Z
menu	M EH N Y UW
mighty	M AY T IY
move	M UW V
oh	OW
one	W AH N
start	S T AA R T
stop	S T AA P
task	T AE S K
three	TH R IY
two	T UW
wakeup	W EY K AH P
weather	W EH DH ER